,unique_tag,secondary_county_y,yr_range,year1,year2,n2_inflow,agi_inflow,n2_outflow,agi_outflow,n2_net,agi_net,arc_county
1,Banks County-Jackson County-GA-1516,"Jackson County, GA",1516,2015,2016,279,4925000,325,5402000,-46,-477000,Banks County
2,Banks County-Habersham County-GA-1516,"Habersham County, GA",1516,2015,2016,208,2719000,352,3907000,-144,-1188000,Banks County
3,Banks County-Hall County-GA-1516,"Hall County, GA",1516,2015,2016,190,2849000,145,2445000,45,404000,Banks County
4,Banks County-Franklin County-GA-1516,"Franklin County, GA",1516,2015,2016,45,689000,51,916000,-6,-227000,Banks County
6,Dawson County-Forsyth County-GA-1516,"Forsyth County, GA",1516,2015,2016,734,31665000,449,11276000,285,20389000,Dawson County
7,Dawson County-Lumpkin County-GA-1516,"Lumpkin County, GA",1516,2015,2016,164,3169000,256,4551000,-92,-1382000,Dawson County
8,Dawson County-Hall County-GA-1516,"Hall County, GA",1516,2015,2016,148,3332000,151,3015000,-3,317000,Dawson County
9,Dawson County-Fulton County-GA-1516,"Fulton County, GA",1516,2015,2016,121,8921000,78,2820000,43,6101000,Dawson County
10,Dawson County-Gwinnett County-GA-1516,"Gwinnett County, GA",1516,2015,2016,118,2963000,63,1393000,55,1570000,Dawson County
11,Dawson County-Cherokee County-GA-1516,"Cherokee County, GA",1516,2015,2016,91,2448000,65,1236000,26,1212000,Dawson County
13,Habersham County-Banks County-GA-1516,"Banks County, GA",1516,2015,2016,352,3907000,208,2719000,144,1188000,Habersham County
14,Habersham County-Hall County-GA-1516,"Hall County, GA",1516,2015,2016,281,4780000,273,4934000,8,-154000,Habersham County
15,Habersham County-White County-GA-1516,"White County, GA",1516,2015,2016,217,3988000,173,3420000,44,568000,Habersham County
16,Habersham County-Stephens County-GA-1516,"Stephens County, GA",1516,2015,2016,99,1914000,126,1804000,-27,110000,Habersham County
17,Habersham County-Gwinnett County-GA-1516,"Gwinnett County, GA",1516,2015,2016,74,1541000,52,1354000,22,187000,Habersham County
18,Habersham County-Lumpkin County-GA-1516,"Lumpkin County, GA",1516,2015,2016,35,536000,50,514000,-15,22000,Habersham County
19,Habersham County-Rabun County-GA-1516,"Rabun County, GA",1516,2015,2016,39,590000,52,830000,-13,-240000,Habersham County
21,Hall County-Gwinnett County-GA-1516,"Gwinnett County, GA",1516,2015,2016,2847,89947000,1620,44363000,1227,45584000,Hall County
22,Hall County-Forsyth County-GA-1516,"Forsyth County, GA",1516,2015,2016,661,20377000,489,13728000,172,6649000,Hall County
23,Hall County-Jackson County-GA-1516,"Jackson County, GA",1516,2015,2016,545,11539000,784,19373000,-239,-7834000,Hall County
24,Hall County-Fulton County-GA-1516,"Fulton County, GA",1516,2015,2016,330,15708000,249,9153000,81,6555000,Hall County
25,Hall County-Lumpkin County-GA-1516,"Lumpkin County, GA",1516,2015,2016,307,6157000,244,4595000,63,1562000,Hall County
26,Hall County-DeKalb County-GA-1516,"DeKalb County, GA",1516,2015,2016,284,7914000,229,7604000,55,310000,Hall County
27,Hall County-Barrow County-GA-1516,"Barrow County, GA",1516,2015,2016,308,7160000,384,7171000,-76,-11000,Hall County
28,Hall County-White County-GA-1516,"White County, GA",1516,2015,2016,277,5012000,311,4608000,-34,404000,Hall County
29,Hall County-Habersham County-GA-1516,"Habersham County, GA",1516,2015,2016,273,4934000,281,4780000,-8,154000,Hall County
30,Hall County-Cobb County-GA-1516,"Cobb County, GA",1516,2015,2016,181,7666000,144,4559000,37,3107000,Hall County
31,Hall County-Dawson County-GA-1516,"Dawson County, GA",1516,2015,2016,151,3015000,148,3332000,3,-317000,Hall County
32,Hall County-Banks County-GA-1516,"Banks County, GA",1516,2015,2016,145,2445000,190,2849000,-45,-404000,Hall County
33,Hall County-Cherokee County-GA-1516,"Cherokee County, GA",1516,2015,2016,118,3781000,55,1630000,63,2151000,Hall County
34,Hall County-Clarke County-GA-1516,"Clarke County, GA",1516,2015,2016,118,2275000,127,2253000,-9,22000,Hall County
35,Hall County-Walton County-GA-1516,"Walton County, GA",1516,2015,2016,86,3062000,70,1278000,16,1784000,Hall County
37,Jackson County-Gwinnett County-GA-1516,"Gwinnett County, GA",1516,2015,2016,1102,33022000,391,10864000,711,22158000,Jackson County
38,Jackson County-Hall County-GA-1516,"Hall County, GA",1516,2015,2016,784,19373000,545,11539000,239,7834000,Jackson County
39,Jackson County-Barrow County-GA-1516,"Barrow County, GA",1516,2015,2016,502,11003000,439,8257000,63,2746000,Jackson County
40,Jackson County-Clarke County-GA-1516,"Clarke County, GA",1516,2015,2016,351,7742000,371,7710000,-20,32000,Jackson County
41,Jackson County-Banks County-GA-1516,"Banks County, GA",1516,2015,2016,325,5402000,279,4925000,46,477000,Jackson County
42,Jackson County-Madison County-GA-1516,"Madison County, GA",1516,2015,2016,187,2284000,176,3156000,11,-872000,Jackson County
43,Jackson County-Walton County-GA-1516,"Walton County, GA",1516,2015,2016,97,1502000,55,853000,42,649000,Jackson County
44,Jackson County-Franklin County-GA-1516,"Franklin County, GA",1516,2015,2016,94,1131000,130,1452000,-36,-321000,Jackson County
45,Jackson County-DeKalb County-GA-1516,"DeKalb County, GA",1516,2015,2016,57,1473000,36,888000,21,585000,Jackson County
46,Jackson County-Oconee County-GA-1516,"Oconee County, GA",1516,2015,2016,66,1526000,76,2408000,-10,-882000,Jackson County
47,Jackson County-Forsyth County-GA-1516,"Forsyth County, GA",1516,2015,2016,71,2129000,37,1098000,34,1031000,Jackson County
48,Jackson County-Fulton County-GA-1516,"Fulton County, GA",1516,2015,2016,49,2015000,50,1141000,-1,874000,Jackson County
50,Lumpkin County-Forsyth County-GA-1516,"Forsyth County, GA",1516,2015,2016,284,6613000,162,3862000,122,2751000,Lumpkin County
51,Lumpkin County-Hall County-GA-1516,"Hall County, GA",1516,2015,2016,244,4595000,307,6157000,-63,-1562000,Lumpkin County
52,Lumpkin County-Dawson County-GA-1516,"Dawson County, GA",1516,2015,2016,256,4551000,164,3169000,92,1382000,Lumpkin County
53,Lumpkin County-Gwinnett County-GA-1516,"Gwinnett County, GA",1516,2015,2016,83,2482000,52,703000,31,1779000,Lumpkin County
54,Lumpkin County-White County-GA-1516,"White County, GA",1516,2015,2016,111,2184000,148,1833000,-37,351000,Lumpkin County
55,Lumpkin County-Fulton County-GA-1516,"Fulton County, GA",1516,2015,2016,53,1948000,38,1567000,15,381000,Lumpkin County
56,Lumpkin County-Habersham County-GA-1516,"Habersham County, GA",1516,2015,2016,50,514000,35,536000,15,-22000,Lumpkin County
58,White County-Hall County-GA-1516,"Hall County, GA",1516,2015,2016,311,4608000,277,5012000,34,-404000,White County
59,White County-Habersham County-GA-1516,"Habersham County, GA",1516,2015,2016,173,3420000,217,3988000,-44,-568000,White County
60,White County-Lumpkin County-GA-1516,"Lumpkin County, GA",1516,2015,2016,148,1833000,111,2184000,37,-351000,White County
61,White County-Gwinnett County-GA-1516,"Gwinnett County, GA",1516,2015,2016,73,2855000,35,837000,38,2018000,White County
63,Banks County-Jackson County-GA-1617,"Jackson County, GA",1617,2016,2017,373,7431000,318,5290000,55,2141000,Banks County
64,Banks County-Habersham County-GA-1617,"Habersham County, GA",1617,2016,2017,284,3703000,281,5156000,3,-1453000,Banks County
65,Banks County-Hall County-GA-1617,"Hall County, GA",1617,2016,2017,255,5726000,178,6324000,77,-598000,Banks County
66,Banks County-Franklin County-GA-1617,"Franklin County, GA",1617,2016,2017,52,991000,99,1092000,-47,-101000,Banks County
67,Banks County-Madison County-GA-1617,"Madison County, GA",1617,2016,2017,42,401000,46,644000,-4,-243000,Banks County
68,Banks County-Clarke County-GA-1617,"Clarke County, GA",1617,2016,2017,46,757000,40,578000,6,179000,Banks County
70,Dawson County-Forsyth County-GA-1617,"Forsyth County, GA",1617,2016,2017,1073,31790000,619,14314000,454,17476000,Dawson County
71,Dawson County-Lumpkin County-GA-1617,"Lumpkin County, GA",1617,2016,2017,248,6219000,340,7916000,-92,-1697000,Dawson County
72,Dawson County-Hall County-GA-1617,"Hall County, GA",1617,2016,2017,212,4544000,172,5570000,40,-1026000,Dawson County
73,Dawson County-Fulton County-GA-1617,"Fulton County, GA",1617,2016,2017,174,8184000,68,2830000,106,5354000,Dawson County
74,Dawson County-Gwinnett County-GA-1617,"Gwinnett County, GA",1617,2016,2017,191,5616000,48,1105000,143,4511000,Dawson County
75,Dawson County-Cherokee County-GA-1617,"Cherokee County, GA",1617,2016,2017,112,2357000,89,2789000,23,-432000,Dawson County
76,Dawson County-DeKalb County-GA-1617,"DeKalb County, GA",1617,2016,2017,34,1597000,32,885000,2,712000,Dawson County
77,Dawson County-Cobb County-GA-1617,"Cobb County, GA",1617,2016,2017,42,2051000,38,1040000,4,1011000,Dawson County
78,Dawson County-Pickens County-GA-1617,"Pickens County, GA",1617,2016,2017,44,1322000,68,1375000,-24,-53000,Dawson County
80,Habersham County-Hall County-GA-1617,"Hall County, GA",1617,2016,2017,451,9281000,300,7072000,151,2209000,Habersham County
81,Habersham County-White County-GA-1617,"White County, GA",1617,2016,2017,308,5212000,243,3860000,65,1352000,Habersham County
82,Habersham County-Banks County-GA-1617,"Banks County, GA",1617,2016,2017,281,5156000,284,3703000,-3,1453000,Habersham County
83,Habersham County-Stephens County-GA-1617,"Stephens County, GA",1617,2016,2017,201,3781000,252,5125000,-51,-1344000,Habersham County
84,Habersham County-Gwinnett County-GA-1617,"Gwinnett County, GA",1617,2016,2017,160,5930000,58,1148000,102,4782000,Habersham County
85,Habersham County-Jackson County-GA-1617,"Jackson County, GA",1617,2016,2017,60,1013000,72,1387000,-12,-374000,Habersham County
86,Habersham County-Rabun County-GA-1617,"Rabun County, GA",1617,2016,2017,63,1415000,62,1531000,1,-116000,Habersham County
87,Habersham County-Franklin County-GA-1617,"Franklin County, GA",1617,2016,2017,48,864000,65,1118000,-17,-254000,Habersham County
89,Hall County-Gwinnett County-GA-1617,"Gwinnett County, GA",1617,2016,2017,3794,130620000,2080,62836000,1714,67784000,Hall County
90,Hall County-Forsyth County-GA-1617,"Forsyth County, GA",1617,2016,2017,955,35692000,628,21712000,327,13980000,Hall County
91,Hall County-Jackson County-GA-1617,"Jackson County, GA",1617,2016,2017,687,14870000,1285,32081000,-598,-17211000,Hall County
92,Hall County-Fulton County-GA-1617,"Fulton County, GA",1617,2016,2017,464,31167000,311,15830000,153,15337000,Hall County
93,Hall County-Barrow County-GA-1617,"Barrow County, GA",1617,2016,2017,487,11939000,579,12805000,-92,-866000,Hall County
94,Hall County-DeKalb County-GA-1617,"DeKalb County, GA",1617,2016,2017,349,11650000,248,7062000,101,4588000,Hall County
95,Hall County-White County-GA-1617,"White County, GA",1617,2016,2017,370,7078000,483,9968000,-113,-2890000,Hall County
96,Hall County-Lumpkin County-GA-1617,"Lumpkin County, GA",1617,2016,2017,314,7454000,347,6603000,-33,851000,Hall County
97,Hall County-Cobb County-GA-1617,"Cobb County, GA",1617,2016,2017,267,12792000,175,5553000,92,7239000,Hall County
98,Hall County-Habersham County-GA-1617,"Habersham County, GA",1617,2016,2017,300,7072000,451,9281000,-151,-2209000,Hall County
99,Hall County-Dawson County-GA-1617,"Dawson County, GA",1617,2016,2017,172,5570000,212,4544000,-40,1026000,Hall County
100,Hall County-Cherokee County-GA-1617,"Cherokee County, GA",1617,2016,2017,171,5311000,102,3340000,69,1971000,Hall County
101,Hall County-Banks County-GA-1617,"Banks County, GA",1617,2016,2017,178,6324000,255,5726000,-77,598000,Hall County
102,Hall County-Walton County-GA-1617,"Walton County, GA",1617,2016,2017,129,2733000,115,3328000,14,-595000,Hall County
103,Hall County-Clarke County-GA-1617,"Clarke County, GA",1617,2016,2017,100,2083000,199,3754000,-99,-1671000,Hall County
104,Hall County-Chatham County-GA-1617,"Chatham County, GA",1617,2016,2017,96,3310000,45,1162000,51,2148000,Hall County
105,Hall County-Henry County-GA-1617,"Henry County, GA",1617,2016,2017,78,2245000,31,1550000,47,695000,Hall County
106,Hall County-Stephens County-GA-1617,"Stephens County, GA",1617,2016,2017,73,1536000,94,1794000,-21,-258000,Hall County
107,Hall County-Harris County-TX-1617,"Harris County, TX",1617,2016,2017,67,1018000,45,788000,22,230000,Hall County
108,Hall County-Rabun County-GA-1617,"Rabun County, GA",1617,2016,2017,39,1236000,34,1461000,5,-225000,Hall County
109,Hall County-Duval County-FL-1617,"Duval County, FL",1617,2016,2017,43,751000,38,686000,5,65000,Hall County
110,Hall County-Pinellas County-FL-1617,"Pinellas County, FL",1617,2016,2017,37,1314000,44,835000,-7,479000,Hall County
112,Jackson County-Gwinnett County-GA-1617,"Gwinnett County, GA",1617,2016,2017,2130,65885000,577,13685000,1553,52200000,Jackson County
113,Jackson County-Hall County-GA-1617,"Hall County, GA",1617,2016,2017,1285,32081000,687,14870000,598,17211000,Jackson County
114,Jackson County-Barrow County-GA-1617,"Barrow County, GA",1617,2016,2017,976,21958000,493,10290000,483,11668000,Jackson County
115,Jackson County-Clarke County-GA-1617,"Clarke County, GA",1617,2016,2017,538,11151000,452,9332000,86,1819000,Jackson County
116,Jackson County-Banks County-GA-1617,"Banks County, GA",1617,2016,2017,318,5290000,373,7431000,-55,-2141000,Jackson County
117,Jackson County-Madison County-GA-1617,"Madison County, GA",1617,2016,2017,253,4407000,300,5237000,-47,-830000,Jackson County
118,Jackson County-Walton County-GA-1617,"Walton County, GA",1617,2016,2017,181,4033000,73,1616000,108,2417000,Jackson County
119,Jackson County-Franklin County-GA-1617,"Franklin County, GA",1617,2016,2017,142,1992000,162,2971000,-20,-979000,Jackson County
120,Jackson County-Fulton County-GA-1617,"Fulton County, GA",1617,2016,2017,108,2761000,74,2261000,34,500000,Jackson County
121,Jackson County-Oconee County-GA-1617,"Oconee County, GA",1617,2016,2017,117,2921000,137,3700000,-20,-779000,Jackson County
122,Jackson County-Forsyth County-GA-1617,"Forsyth County, GA",1617,2016,2017,89,2461000,57,1767000,32,694000,Jackson County
123,Jackson County-DeKalb County-GA-1617,"DeKalb County, GA",1617,2016,2017,59,2136000,50,1802000,9,334000,Jackson County
124,Jackson County-Habersham County-GA-1617,"Habersham County, GA",1617,2016,2017,72,1387000,60,1013000,12,374000,Jackson County
125,Jackson County-Oglethorpe County-GA-1617,"Oglethorpe County, GA",1617,2016,2017,50,1218000,44,645000,6,573000,Jackson County
126,Jackson County-Hart County-GA-1617,"Hart County, GA",1617,2016,2017,39,852000,61,2494000,-22,-1642000,Jackson County
128,Lumpkin County-Forsyth County-GA-1617,"Forsyth County, GA",1617,2016,2017,445,13174000,229,5980000,216,7194000,Lumpkin County
129,Lumpkin County-Hall County-GA-1617,"Hall County, GA",1617,2016,2017,347,6603000,314,7454000,33,-851000,Lumpkin County
130,Lumpkin County-Dawson County-GA-1617,"Dawson County, GA",1617,2016,2017,340,7916000,248,6219000,92,1697000,Lumpkin County
131,Lumpkin County-Gwinnett County-GA-1617,"Gwinnett County, GA",1617,2016,2017,161,5249000,41,1089000,120,4160000,Lumpkin County
132,Lumpkin County-Fulton County-GA-1617,"Fulton County, GA",1617,2016,2017,107,4532000,55,1501000,52,3031000,Lumpkin County
133,Lumpkin County-White County-GA-1617,"White County, GA",1617,2016,2017,120,2016000,183,3680000,-63,-1664000,Lumpkin County
135,White County-Hall County-GA-1617,"Hall County, GA",1617,2016,2017,483,9968000,370,7078000,113,2890000,White County
136,White County-Habersham County-GA-1617,"Habersham County, GA",1617,2016,2017,243,3860000,308,5212000,-65,-1352000,White County
137,White County-Lumpkin County-GA-1617,"Lumpkin County, GA",1617,2016,2017,183,3680000,120,2016000,63,1664000,White County
138,White County-Gwinnett County-GA-1617,"Gwinnett County, GA",1617,2016,2017,154,5963000,47,1413000,107,4550000,White County
139,White County-Forsyth County-GA-1617,"Forsyth County, GA",1617,2016,2017,119,5287000,34,909000,85,4378000,White County
141,Banks County-Jackson County-GA-1718,"Jackson County, GA",1718,2017,2018,417,6722000,306,5312000,111,1410000,Banks County
142,Banks County-Hall County-GA-1718,"Hall County, GA",1718,2017,2018,296,5584000,162,3595000,134,1989000,Banks County
143,Banks County-Habersham County-GA-1718,"Habersham County, GA",1718,2017,2018,176,2960000,260,3970000,-84,-1010000,Banks County
144,Banks County-Madison County-GA-1718,"Madison County, GA",1718,2017,2018,52,705000,51,626000,1,79000,Banks County
145,Banks County-Franklin County-GA-1718,"Franklin County, GA",1718,2017,2018,45,808000,63,623000,-18,185000,Banks County
147,Dawson County-Forsyth County-GA-1718,"Forsyth County, GA",1718,2017,2018,796,29608000,512,12518000,284,17090000,Dawson County
148,Dawson County-Lumpkin County-GA-1718,"Lumpkin County, GA",1718,2017,2018,179,6164000,260,4210000,-81,1954000,Dawson County
149,Dawson County-Hall County-GA-1718,"Hall County, GA",1718,2017,2018,160,5773000,171,4782000,-11,991000,Dawson County
150,Dawson County-Fulton County-GA-1718,"Fulton County, GA",1718,2017,2018,120,7057000,38,2503000,82,4554000,Dawson County
151,Dawson County-Cherokee County-GA-1718,"Cherokee County, GA",1718,2017,2018,99,3021000,50,1411000,49,1610000,Dawson County
152,Dawson County-Pickens County-GA-1718,"Pickens County, GA",1718,2017,2018,45,1029000,42,1394000,3,-365000,Dawson County
154,Habersham County-Hall County-GA-1718,"Hall County, GA",1718,2017,2018,300,6276000,255,5129000,45,1147000,Habersham County
155,Habersham County-White County-GA-1718,"White County, GA",1718,2017,2018,249,4471000,245,5191000,4,-720000,Habersham County
156,Habersham County-Banks County-GA-1718,"Banks County, GA",1718,2017,2018,260,3970000,176,2960000,84,1010000,Habersham County
157,Habersham County-Stephens County-GA-1718,"Stephens County, GA",1718,2017,2018,189,4048000,210,7363000,-21,-3315000,Habersham County
158,Habersham County-Gwinnett County-GA-1718,"Gwinnett County, GA",1718,2017,2018,121,3690000,68,1841000,53,1849000,Habersham County
159,Habersham County-Rabun County-GA-1718,"Rabun County, GA",1718,2017,2018,44,1032000,49,928000,-5,104000,Habersham County
160,Habersham County-Jackson County-GA-1718,"Jackson County, GA",1718,2017,2018,42,1101000,46,1303000,-4,-202000,Habersham County
162,Hall County-Gwinnett County-GA-1718,"Gwinnett County, GA",1718,2017,2018,3047,109712000,1781,50233000,1266,59479000,Hall County
163,Hall County-Forsyth County-GA-1718,"Forsyth County, GA",1718,2017,2018,742,29704000,620,16504000,122,13200000,Hall County
164,Hall County-Jackson County-GA-1718,"Jackson County, GA",1718,2017,2018,644,16087000,1002,23090000,-358,-7003000,Hall County
165,Hall County-Fulton County-GA-1718,"Fulton County, GA",1718,2017,2018,369,19474000,300,12085000,69,7389000,Hall County
166,Hall County-Barrow County-GA-1718,"Barrow County, GA",1718,2017,2018,377,8299000,441,9241000,-64,-942000,Hall County
167,Hall County-Lumpkin County-GA-1718,"Lumpkin County, GA",1718,2017,2018,316,8008000,285,7417000,31,591000,Hall County
168,Hall County-DeKalb County-GA-1718,"DeKalb County, GA",1718,2017,2018,293,7656000,234,6462000,59,1194000,Hall County
169,Hall County-White County-GA-1718,"White County, GA",1718,2017,2018,320,6727000,384,8694000,-64,-1967000,Hall County
170,Hall County-Cobb County-GA-1718,"Cobb County, GA",1718,2017,2018,220,7081000,192,5212000,28,1869000,Hall County
171,Hall County-Habersham County-GA-1718,"Habersham County, GA",1718,2017,2018,255,5129000,300,6276000,-45,-1147000,Hall County
172,Hall County-Dawson County-GA-1718,"Dawson County, GA",1718,2017,2018,171,4782000,160,5773000,11,-991000,Hall County
173,Hall County-Banks County-GA-1718,"Banks County, GA",1718,2017,2018,162,3595000,296,5584000,-134,-1989000,Hall County
174,Hall County-Clarke County-GA-1718,"Clarke County, GA",1718,2017,2018,113,2627000,130,3648000,-17,-1021000,Hall County
175,Hall County-Walton County-GA-1718,"Walton County, GA",1718,2017,2018,107,2701000,80,1973000,27,728000,Hall County
176,Hall County-Cherokee County-GA-1718,"Cherokee County, GA",1718,2017,2018,72,3987000,97,4183000,-25,-196000,Hall County
177,Hall County-Stephens County-GA-1718,"Stephens County, GA",1718,2017,2018,41,890000,50,669000,-9,221000,Hall County
179,Jackson County-Gwinnett County-GA-1718,"Gwinnett County, GA",1718,2017,2018,1641,53223000,530,14836000,1111,38387000,Jackson County
180,Jackson County-Hall County-GA-1718,"Hall County, GA",1718,2017,2018,1002,23090000,644,16087000,358,7003000,Jackson County
181,Jackson County-Barrow County-GA-1718,"Barrow County, GA",1718,2017,2018,664,15434000,516,12067000,148,3367000,Jackson County
182,Jackson County-Clarke County-GA-1718,"Clarke County, GA",1718,2017,2018,568,11670000,341,6316000,227,5354000,Jackson County
183,Jackson County-Banks County-GA-1718,"Banks County, GA",1718,2017,2018,306,5312000,417,6722000,-111,-1410000,Jackson County
184,Jackson County-Madison County-GA-1718,"Madison County, GA",1718,2017,2018,156,2892000,174,3005000,-18,-113000,Jackson County
185,Jackson County-Fulton County-GA-1718,"Fulton County, GA",1718,2017,2018,88,3830000,77,2371000,11,1459000,Jackson County
186,Jackson County-DeKalb County-GA-1718,"DeKalb County, GA",1718,2017,2018,73,2327000,31,1146000,42,1181000,Jackson County
187,Jackson County-Oconee County-GA-1718,"Oconee County, GA",1718,2017,2018,95,2378000,71,1515000,24,863000,Jackson County
188,Jackson County-Forsyth County-GA-1718,"Forsyth County, GA",1718,2017,2018,93,3056000,72,1823000,21,1233000,Jackson County
189,Jackson County-Franklin County-GA-1718,"Franklin County, GA",1718,2017,2018,84,1246000,169,2487000,-85,-1241000,Jackson County
190,Jackson County-Walton County-GA-1718,"Walton County, GA",1718,2017,2018,95,2716000,80,1470000,15,1246000,Jackson County
191,Jackson County-Habersham County-GA-1718,"Habersham County, GA",1718,2017,2018,46,1303000,42,1101000,4,202000,Jackson County
193,Lumpkin County-Forsyth County-GA-1718,"Forsyth County, GA",1718,2017,2018,320,10528000,207,4537000,113,5991000,Lumpkin County
194,Lumpkin County-Hall County-GA-1718,"Hall County, GA",1718,2017,2018,285,7417000,316,8008000,-31,-591000,Lumpkin County
195,Lumpkin County-Dawson County-GA-1718,"Dawson County, GA",1718,2017,2018,260,4210000,179,6164000,81,-1954000,Lumpkin County
196,Lumpkin County-White County-GA-1718,"White County, GA",1718,2017,2018,103,2047000,132,2666000,-29,-619000,Lumpkin County
197,Lumpkin County-Fulton County-GA-1718,"Fulton County, GA",1718,2017,2018,78,6344000,46,1469000,32,4875000,Lumpkin County
198,Lumpkin County-Gwinnett County-GA-1718,"Gwinnett County, GA",1718,2017,2018,60,1233000,35,1033000,25,200000,Lumpkin County
200,White County-Hall County-GA-1718,"Hall County, GA",1718,2017,2018,384,8694000,320,6727000,64,1967000,White County
201,White County-Habersham County-GA-1718,"Habersham County, GA",1718,2017,2018,245,5191000,249,4471000,-4,720000,White County
202,White County-Lumpkin County-GA-1718,"Lumpkin County, GA",1718,2017,2018,132,2666000,103,2047000,29,619000,White County
203,White County-Gwinnett County-GA-1718,"Gwinnett County, GA",1718,2017,2018,67,1900000,32,651000,35,1249000,White County
204,White County-Forsyth County-GA-1718,"Forsyth County, GA",1718,2017,2018,69,2265000,47,1556000,22,709000,White County
206,Banks County-Hall County-GA-1819,"Hall County, GA",1819,2018,2019,319,6445000,157,3374000,162,3071000,Banks County
207,Banks County-Jackson County-GA-1819,"Jackson County, GA",1819,2018,2019,328,5650000,235,4137000,93,1513000,Banks County
208,Banks County-Habersham County-GA-1819,"Habersham County, GA",1819,2018,2019,242,3340000,223,3620000,19,-280000,Banks County
209,Banks County-Franklin County-GA-1819,"Franklin County, GA",1819,2018,2019,46,766000,57,1028000,-11,-262000,Banks County
210,Banks County-Madison County-GA-1819,"Madison County, GA",1819,2018,2019,52,953000,42,1037000,10,-84000,Banks County
212,Dawson County-Forsyth County-GA-1819,"Forsyth County, GA",1819,2018,2019,912,30356000,491,14495000,421,15861000,Dawson County
213,Dawson County-Lumpkin County-GA-1819,"Lumpkin County, GA",1819,2018,2019,269,7166000,301,7033000,-32,133000,Dawson County
214,Dawson County-Hall County-GA-1819,"Hall County, GA",1819,2018,2019,140,3581000,147,3885000,-7,-304000,Dawson County
215,Dawson County-Gwinnett County-GA-1819,"Gwinnett County, GA",1819,2018,2019,147,4676000,47,1381000,100,3295000,Dawson County
216,Dawson County-Fulton County-GA-1819,"Fulton County, GA",1819,2018,2019,124,7397000,66,2787000,58,4610000,Dawson County
217,Dawson County-Pickens County-GA-1819,"Pickens County, GA",1819,2018,2019,73,1826000,39,1236000,34,590000,Dawson County
219,Habersham County-Hall County-GA-1819,"Hall County, GA",1819,2018,2019,372,7849000,264,5919000,108,1930000,Habersham County
220,Habersham County-Banks County-GA-1819,"Banks County, GA",1819,2018,2019,223,3620000,242,3340000,-19,280000,Habersham County
221,Habersham County-White County-GA-1819,"White County, GA",1819,2018,2019,199,3492000,251,4963000,-52,-1471000,Habersham County
222,Habersham County-Stephens County-GA-1819,"Stephens County, GA",1819,2018,2019,182,3362000,161,3344000,21,18000,Habersham County
223,Habersham County-Gwinnett County-GA-1819,"Gwinnett County, GA",1819,2018,2019,141,6310000,62,1915000,79,4395000,Habersham County
224,Habersham County-Rabun County-GA-1819,"Rabun County, GA",1819,2018,2019,65,1246000,68,1192000,-3,54000,Habersham County
225,Habersham County-Fulton County-GA-1819,"Fulton County, GA",1819,2018,2019,39,1653000,44,1908000,-5,-255000,Habersham County
226,Habersham County-Franklin County-GA-1819,"Franklin County, GA",1819,2018,2019,48,864000,53,823000,-5,41000,Habersham County
227,Habersham County-Jackson County-GA-1819,"Jackson County, GA",1819,2018,2019,41,881000,76,1263000,-35,-382000,Habersham County
229,Hall County-Gwinnett County-GA-1819,"Gwinnett County, GA",1819,2018,2019,2999,109271000,1685,46474000,1314,62797000,Hall County
230,Hall County-Forsyth County-GA-1819,"Forsyth County, GA",1819,2018,2019,695,33179000,545,19846000,150,13333000,Hall County
231,Hall County-Jackson County-GA-1819,"Jackson County, GA",1819,2018,2019,649,16378000,999,29325000,-350,-12947000,Hall County
232,Hall County-Fulton County-GA-1819,"Fulton County, GA",1819,2018,2019,401,24176000,339,19364000,62,4812000,Hall County
233,Hall County-Barrow County-GA-1819,"Barrow County, GA",1819,2018,2019,377,19416000,431,9392000,-54,10024000,Hall County
234,Hall County-Lumpkin County-GA-1819,"Lumpkin County, GA",1819,2018,2019,287,6687000,317,6188000,-30,499000,Hall County
235,Hall County-White County-GA-1819,"White County, GA",1819,2018,2019,316,5953000,361,8620000,-45,-2667000,Hall County
236,Hall County-DeKalb County-GA-1819,"DeKalb County, GA",1819,2018,2019,240,6665000,195,7363000,45,-698000,Hall County
237,Hall County-Habersham County-GA-1819,"Habersham County, GA",1819,2018,2019,264,5919000,372,7849000,-108,-1930000,Hall County
238,Hall County-Cobb County-GA-1819,"Cobb County, GA",1819,2018,2019,162,9186000,165,4897000,-3,4289000,Hall County
239,Hall County-Dawson County-GA-1819,"Dawson County, GA",1819,2018,2019,147,3885000,140,3581000,7,304000,Hall County
240,Hall County-Banks County-GA-1819,"Banks County, GA",1819,2018,2019,157,3374000,319,6445000,-162,-3071000,Hall County
241,Hall County-Clarke County-GA-1819,"Clarke County, GA",1819,2018,2019,112,2419000,142,2855000,-30,-436000,Hall County
242,Hall County-Cherokee County-GA-1819,"Cherokee County, GA",1819,2018,2019,135,4126000,101,4155000,34,-29000,Hall County
243,Hall County-Walton County-GA-1819,"Walton County, GA",1819,2018,2019,67,1403000,72,1972000,-5,-569000,Hall County
244,Hall County-Stephens County-GA-1819,"Stephens County, GA",1819,2018,2019,75,1393000,59,2283000,16,-890000,Hall County
245,Hall County-Clayton County-GA-1819,"Clayton County, GA",1819,2018,2019,54,837000,40,538000,14,299000,Hall County
247,Jackson County-Gwinnett County-GA-1819,"Gwinnett County, GA",1819,2018,2019,1562,50911000,465,21230000,1097,29681000,Jackson County
248,Jackson County-Hall County-GA-1819,"Hall County, GA",1819,2018,2019,999,29325000,649,16378000,350,12947000,Jackson County
249,Jackson County-Barrow County-GA-1819,"Barrow County, GA",1819,2018,2019,682,15362000,421,13799000,261,1563000,Jackson County
250,Jackson County-Clarke County-GA-1819,"Clarke County, GA",1819,2018,2019,447,9600000,387,9267000,60,333000,Jackson County
251,Jackson County-Banks County-GA-1819,"Banks County, GA",1819,2018,2019,235,4137000,328,5650000,-93,-1513000,Jackson County
252,Jackson County-Madison County-GA-1819,"Madison County, GA",1819,2018,2019,156,3252000,155,2404000,1,848000,Jackson County
253,Jackson County-Walton County-GA-1819,"Walton County, GA",1819,2018,2019,131,3285000,62,2835000,69,450000,Jackson County
254,Jackson County-DeKalb County-GA-1819,"DeKalb County, GA",1819,2018,2019,71,2397000,57,1495000,14,902000,Jackson County
255,Jackson County-Fulton County-GA-1819,"Fulton County, GA",1819,2018,2019,76,3408000,69,2920000,7,488000,Jackson County
256,Jackson County-Oconee County-GA-1819,"Oconee County, GA",1819,2018,2019,101,2484000,93,2267000,8,217000,Jackson County
257,Jackson County-Forsyth County-GA-1819,"Forsyth County, GA",1819,2018,2019,70,2920000,61,2090000,9,830000,Jackson County
258,Jackson County-Habersham County-GA-1819,"Habersham County, GA",1819,2018,2019,76,1263000,41,881000,35,382000,Jackson County
259,Jackson County-Franklin County-GA-1819,"Franklin County, GA",1819,2018,2019,55,1218000,104,2264000,-49,-1046000,Jackson County
260,Jackson County-White County-GA-1819,"White County, GA",1819,2018,2019,39,1101000,52,1163000,-13,-62000,Jackson County
262,Lumpkin County-Forsyth County-GA-1819,"Forsyth County, GA",1819,2018,2019,309,11468000,180,4600000,129,6868000,Lumpkin County
263,Lumpkin County-Hall County-GA-1819,"Hall County, GA",1819,2018,2019,317,6188000,287,6687000,30,-499000,Lumpkin County
264,Lumpkin County-Dawson County-GA-1819,"Dawson County, GA",1819,2018,2019,301,7033000,269,7166000,32,-133000,Lumpkin County
265,Lumpkin County-White County-GA-1819,"White County, GA",1819,2018,2019,123,2898000,166,2768000,-43,130000,Lumpkin County
266,Lumpkin County-Gwinnett County-GA-1819,"Gwinnett County, GA",1819,2018,2019,78,3001000,67,1529000,11,1472000,Lumpkin County
267,Lumpkin County-Fulton County-GA-1819,"Fulton County, GA",1819,2018,2019,43,1975000,50,1812000,-7,163000,Lumpkin County
268,Lumpkin County-Cherokee County-GA-1819,"Cherokee County, GA",1819,2018,2019,41,1613000,36,905000,5,708000,Lumpkin County
270,White County-Hall County-GA-1819,"Hall County, GA",1819,2018,2019,361,8620000,316,5953000,45,2667000,White County
271,White County-Habersham County-GA-1819,"Habersham County, GA",1819,2018,2019,251,4963000,199,3492000,52,1471000,White County
272,White County-Lumpkin County-GA-1819,"Lumpkin County, GA",1819,2018,2019,166,2768000,123,2898000,43,-130000,White County
273,White County-Gwinnett County-GA-1819,"Gwinnett County, GA",1819,2018,2019,105,3650000,38,1086000,67,2564000,White County
274,White County-Forsyth County-GA-1819,"Forsyth County, GA",1819,2018,2019,70,2937000,38,1040000,32,1897000,White County
275,White County-Jackson County-GA-1819,"Jackson County, GA",1819,2018,2019,52,1163000,39,1101000,13,62000,White County
277,Banks County-Jackson County-GA-1920,"Jackson County, GA",1920,2019,2020,394,7943000,318,4527000,76,3416000,Banks County
278,Banks County-Hall County-GA-1920,"Hall County, GA",1920,2019,2020,283,6514000,194,4626000,89,1888000,Banks County
279,Banks County-Habersham County-GA-1920,"Habersham County, GA",1920,2019,2020,224,3986000,268,4032000,-44,-46000,Banks County
280,Banks County-Franklin County-GA-1920,"Franklin County, GA",1920,2019,2020,57,1064000,79,1330000,-22,-266000,Banks County
281,Banks County-Madison County-GA-1920,"Madison County, GA",1920,2019,2020,42,784000,55,1384000,-13,-600000,Banks County
283,Dawson County-Forsyth County-GA-1920,"Forsyth County, GA",1920,2019,2020,1149,37380000,470,14269000,679,23111000,Dawson County
284,Dawson County-Fulton County-GA-1920,"Fulton County, GA",1920,2019,2020,195,18791000,63,2638000,132,16153000,Dawson County
285,Dawson County-Lumpkin County-GA-1920,"Lumpkin County, GA",1920,2019,2020,216,5102000,314,7858000,-98,-2756000,Dawson County
286,Dawson County-Hall County-GA-1920,"Hall County, GA",1920,2019,2020,156,4460000,170,4838000,-14,-378000,Dawson County
287,Dawson County-Gwinnett County-GA-1920,"Gwinnett County, GA",1920,2019,2020,160,5776000,80,2613000,80,3163000,Dawson County
288,Dawson County-Cherokee County-GA-1920,"Cherokee County, GA",1920,2019,2020,127,3352000,58,2015000,69,1337000,Dawson County
289,Dawson County-Pickens County-GA-1920,"Pickens County, GA",1920,2019,2020,59,2020000,58,1437000,1,583000,Dawson County
291,Habersham County-Hall County-GA-1920,"Hall County, GA",1920,2019,2020,422,9762000,256,5843000,166,3919000,Habersham County
292,Habersham County-White County-GA-1920,"White County, GA",1920,2019,2020,287,6037000,271,5057000,16,980000,Habersham County
293,Habersham County-Banks County-GA-1920,"Banks County, GA",1920,2019,2020,268,4032000,224,3986000,44,46000,Habersham County
294,Habersham County-Gwinnett County-GA-1920,"Gwinnett County, GA",1920,2019,2020,176,6387000,58,1886000,118,4501000,Habersham County
295,Habersham County-Stephens County-GA-1920,"Stephens County, GA",1920,2019,2020,171,3065000,155,3408000,16,-343000,Habersham County
296,Habersham County-Rabun County-GA-1920,"Rabun County, GA",1920,2019,2020,105,2974000,71,1516000,34,1458000,Habersham County
297,Habersham County-Jackson County-GA-1920,"Jackson County, GA",1920,2019,2020,93,1858000,49,908000,44,950000,Habersham County
299,Hall County-Gwinnett County-GA-1920,"Gwinnett County, GA",1920,2019,2020,3844,150485000,1568,46450000,2276,104035000,Hall County
300,Hall County-Forsyth County-GA-1920,"Forsyth County, GA",1920,2019,2020,956,40503000,612,19963000,344,20540000,Hall County
301,Hall County-Jackson County-GA-1920,"Jackson County, GA",1920,2019,2020,764,22690000,1159,27834000,-395,-5144000,Hall County
302,Hall County-Fulton County-GA-1920,"Fulton County, GA",1920,2019,2020,432,27556000,307,18049000,125,9507000,Hall County
303,Hall County-Barrow County-GA-1920,"Barrow County, GA",1920,2019,2020,355,9406000,473,11187000,-118,-1781000,Hall County
304,Hall County-DeKalb County-GA-1920,"DeKalb County, GA",1920,2019,2020,292,13198000,197,7369000,95,5829000,Hall County
305,Hall County-Lumpkin County-GA-1920,"Lumpkin County, GA",1920,2019,2020,304,6621000,327,7682000,-23,-1061000,Hall County
306,Hall County-White County-GA-1920,"White County, GA",1920,2019,2020,288,6586000,409,8137000,-121,-1551000,Hall County
307,Hall County-Habersham County-GA-1920,"Habersham County, GA",1920,2019,2020,256,5843000,422,9762000,-166,-3919000,Hall County
308,Hall County-Cobb County-GA-1920,"Cobb County, GA",1920,2019,2020,217,14505000,148,4709000,69,9796000,Hall County
309,Hall County-Banks County-GA-1920,"Banks County, GA",1920,2019,2020,194,4626000,283,6514000,-89,-1888000,Hall County
310,Hall County-Clarke County-GA-1920,"Clarke County, GA",1920,2019,2020,132,3391000,152,4707000,-20,-1316000,Hall County
311,Hall County-Dawson County-GA-1920,"Dawson County, GA",1920,2019,2020,170,4838000,156,4460000,14,378000,Hall County
312,Hall County-Cherokee County-GA-1920,"Cherokee County, GA",1920,2019,2020,193,8928000,93,3355000,100,5573000,Hall County
313,Hall County-Walton County-GA-1920,"Walton County, GA",1920,2019,2020,118,3593000,90,2635000,28,958000,Hall County
314,Hall County-Stephens County-GA-1920,"Stephens County, GA",1920,2019,2020,73,1645000,91,2567000,-18,-922000,Hall County
315,Hall County-Orange County-FL-1920,"Orange County, FL",1920,2019,2020,33,1021000,38,885000,-5,136000,Hall County
316,Hall County-Mecklenburg County-NC-1920,"Mecklenburg County, NC",1920,2019,2020,37,2082000,31,865000,6,1217000,Hall County
318,Jackson County-Gwinnett County-GA-1920,"Gwinnett County, GA",1920,2019,2020,2223,72482000,484,14320000,1739,58162000,Jackson County
319,Jackson County-Hall County-GA-1920,"Hall County, GA",1920,2019,2020,1159,27834000,764,22690000,395,5144000,Jackson County
320,Jackson County-Barrow County-GA-1920,"Barrow County, GA",1920,2019,2020,886,19865000,430,10956000,456,8909000,Jackson County
321,Jackson County-Clarke County-GA-1920,"Clarke County, GA",1920,2019,2020,520,12796000,370,7756000,150,5040000,Jackson County
322,Jackson County-Banks County-GA-1920,"Banks County, GA",1920,2019,2020,318,4527000,394,7943000,-76,-3416000,Jackson County
323,Jackson County-Madison County-GA-1920,"Madison County, GA",1920,2019,2020,140,3379000,210,4694000,-70,-1315000,Jackson County
324,Jackson County-Forsyth County-GA-1920,"Forsyth County, GA",1920,2019,2020,126,4435000,88,3408000,38,1027000,Jackson County
325,Jackson County-Fulton County-GA-1920,"Fulton County, GA",1920,2019,2020,106,4287000,75,2077000,31,2210000,Jackson County
326,Jackson County-Walton County-GA-1920,"Walton County, GA",1920,2019,2020,114,3022000,81,1889000,33,1133000,Jackson County
327,Jackson County-DeKalb County-GA-1920,"DeKalb County, GA",1920,2019,2020,88,5021000,35,1337000,53,3684000,Jackson County
328,Jackson County-Franklin County-GA-1920,"Franklin County, GA",1920,2019,2020,101,2762000,162,3411000,-61,-649000,Jackson County
329,Jackson County-Oconee County-GA-1920,"Oconee County, GA",1920,2019,2020,93,2384000,104,3285000,-11,-901000,Jackson County
330,Jackson County-Habersham County-GA-1920,"Habersham County, GA",1920,2019,2020,49,908000,93,1858000,-44,-950000,Jackson County
331,Jackson County-Cobb County-GA-1920,"Cobb County, GA",1920,2019,2020,51,1957000,51,1217000,0,740000,Jackson County
333,Lumpkin County-Forsyth County-GA-1920,"Forsyth County, GA",1920,2019,2020,410,11476000,182,4558000,228,6918000,Lumpkin County
334,Lumpkin County-Hall County-GA-1920,"Hall County, GA",1920,2019,2020,327,7682000,304,6621000,23,1061000,Lumpkin County
335,Lumpkin County-Dawson County-GA-1920,"Dawson County, GA",1920,2019,2020,314,7858000,216,5102000,98,2756000,Lumpkin County
336,Lumpkin County-Gwinnett County-GA-1920,"Gwinnett County, GA",1920,2019,2020,105,3284000,49,1378000,56,1906000,Lumpkin County
337,Lumpkin County-White County-GA-1920,"White County, GA",1920,2019,2020,110,2162000,162,2957000,-52,-795000,Lumpkin County
338,Lumpkin County-Fulton County-GA-1920,"Fulton County, GA",1920,2019,2020,84,6078000,40,1428000,44,4650000,Lumpkin County
339,Lumpkin County-Cherokee County-GA-1920,"Cherokee County, GA",1920,2019,2020,59,1222000,47,2350000,12,-1128000,Lumpkin County
340,Lumpkin County-Cobb County-GA-1920,"Cobb County, GA",1920,2019,2020,45,4817000,27,885000,18,3932000,Lumpkin County
342,White County-Hall County-GA-1920,"Hall County, GA",1920,2019,2020,409,8137000,288,6586000,121,1551000,White County
343,White County-Habersham County-GA-1920,"Habersham County, GA",1920,2019,2020,271,5057000,287,6037000,-16,-980000,White County
344,White County-Lumpkin County-GA-1920,"Lumpkin County, GA",1920,2019,2020,162,2957000,110,2162000,52,795000,White County
345,White County-Gwinnett County-GA-1920,"Gwinnett County, GA",1920,2019,2020,144,4768000,69,2407000,75,2361000,White County
346,White County-Forsyth County-GA-1920,"Forsyth County, GA",1920,2019,2020,135,4574000,73,1539000,62,3035000,White County
